***X***X*****X*X****
*X*X*XXXXX*XXX*X*XXX
*X*X*X***********X*X
XX*X*X*X*XXXXX*X*X*X
*******X*****X*X****
XXXXXXXXXX*XXXXXXX*X
*X*X*X*X*X*X*X******
*X*X*X*X*X*X*XXX*X*X
*X*******X***X*X*X**
*XXX*XXX*X*XXX*X*XXX
*****X*X*X***X******
XXXXXX*X*X*X*XXXXXXX
*******X***X***X***X
XXXXXX*X*XXX*XXXXX*X
***X***X***X*X*X****
*XXX*XXXXX*XXX*X*XXX
*******X*X**********
XX*XXXXX*X*X*XXX*XXX
***********X***X***X
*X*X*X*X*X*X*X*XXX**
